box-sizing: border-box          边框算在width和height里面
                  content-box         默认，边框会向外拓展

appearance: none                不应用任何特殊样式(常用于input控件之中做设计)。

input[id="switch_botton"]:checked::after    对于伪类元素，checked在前，伪类(::after在后)

display:flex    可以将当前元素设置为一个容器， 其子元素就相当于是容器内的盒子
                可在当前元素内设置        justify-content: center;       主轴居中(垂直方向)
                                        align-items: center;           交叉轴居中(水平方向)
                                        justify-self：center       属性设置单个盒子在其布局容器适当轴中的对其方式。

CSS属性：
            url 	需使用的自定义光标的 URL。
                    注释：请在此列表的末端始终定义一种普通的光标，以防没有由 URL 定义的可用光标。
            default 	默认光标（通常是一个箭头）
            auto 	默认。浏览器设置的光标。
            crosshair 	光标呈现为十字线。
            pointer 	光标呈现为指示链接的指针（一只手）
            move 	此光标指示某对象可被移动。
            e-resize 	此光标指示矩形框的边缘可被向右（东）移动。
            ne-resize 	此光标指示矩形框的边缘可被向上及向右移动（北/东）。
            nw-resize 	此光标指示矩形框的边缘可被向上及向左移动（北/西）。
            n-resize 	此光标指示矩形框的边缘可被向上（北）移动。
            se-resize 	此光标指示矩形框的边缘可被向下及向右移动（南/东）。
            sw-resize 	此光标指示矩形框的边缘可被向下及向左移动（南/西）。
            s-resize 	此光标指示矩形框的边缘可被向下移动（南）。
            w-resize 	此光标指示矩形框的边缘可被向左移动（西）。
            text 	此光标指示文本。
            wait 	此光标指示程序正忙（通常是一只表或沙漏）。
            help 	此光标指示可用的帮助（通常是一个问号或一个气球）。

filter：drop-shadow(h-shadow v-shadow blur spread color) 	

    对图像应用阴影效果。可能的值：

            h-shadow - 必需。指定水平阴影的像素值。负值会将阴影放置在图像的左侧。
            v-shadow - 必需。指定垂直阴影的像素值。负值会将阴影放置在图像上方。

            blur -可选。这是第三个值，单位必须用像素。为阴影添加模糊效果。值越大创建的模糊就越多（阴影会变得更大更亮）。不允许负值。如果未规定值，会使用 0（阴影的边缘很锐利）。

            spread - 可选。这是第四个值，单位必须用像素。正值将导致阴影扩展并增大，负值将导致阴影缩小。如果未规定值，会使用 0（阴影与元素的大小相同）。

            注释：Chrome、Safari 和 Opera，也许还有其他浏览器，不支持第 4 个长度；如果添加，则不会呈现。

            color - 可选。为阴影添加颜色。如果未规定，则颜色取决于浏览器（通常为黑色）。

            这个例子创建了红色的阴影，水平和垂直方向均为 8px，带有 10px 的模糊效果：

            filter: drop-shadow(8px 8px 10px red);

            提示：这个滤镜类似 box-shadow 属性。













